####################
#     ###          E
##### ### ##########
#       # # ## ### #
# ##### # # ## ### #
# ##### # #      # #
#     # # ###### # #
##### # # ###### # #
##### ###        # #
#         ######## #
######### ######## #
S                  #
####################
